11111111
10010001
11000101
10010001
10111111
10010001
10000101
11111111
