################
#              #
#              #
#  #           #
#              #
###  ##   ###  #
#   ##         #
#    #         #
#  ###         #
#             ##
#              #
###      ##    #
#     ####     #
#    # #  ##   #
#O     #       #
################
