################################
#                              #
#                              #
#  #            #              #
#               #              #
###  ##         #         ###  #
#   ##          #              #
#    #          #              #
#  ###          #              #
#       # #     #             ##
#         ####  #              #
#    O       # ##              #
#   ###         #              #
#  ##     #  #  #              #
# #     ##   ####              #
##     # #  ##  #              #
#      #        #              #
#   #############              #
#               #              #
#               #              #
#               #              #
#               #              #
#               #              #
#                              #
#                              #
#                              #
#                              #
###                      ##    #
#     ####################     #
#    # #                  ##   #
# #    #                       #
################################
