################
#  #     #     #
# #            #
#    O      #  #
#   ###      # #
#  ##        ###
# #     #    # #
##     #   ##  #
#      #       #
#   #####   #  #
#              #
###      ##    #
#     ####     #
#    # #  ##   #
# #    #       #
################
