################
#              #
#              #
#              #
#              #
#              #
#              #
#              #
#              #
#              #
#              #
#        #     #
#      ###     #
#     ##       #
#O     #       #
################
